######################################################################################################
#----------------------------------------------------------------------------------------------------#
#----------------------------------------------------------------------------------------------------#
#----------------------------------------------------------------------------------------------------#
#----------------------------------------------------------------------------------------------------#
#----------------------------------------------------------------------------------------------------#
#--------------------------$$------------------------------------------------------------------------#
#----------------------------------------------------------------------------------------------------#
#-----------------------------------------------------------------$$---------------------------------#
#---------------------------------------------------------------$$$$---------------------------------#
#-------------------------------------####-----------------------$-----------------------------------#
#----------------------------------####**#-----------------------------------------------------------#
#---------------------------------##@****##----------------------------------------------------------#
#------------------$---------------##***#####--------------------------------------------------------#
#-----------------------------------##*####--------------------%-------------------------------------#
#-----------------------dd-----------#q#--------------------%%%%-------------------------------------#
#--------------##---------------------------------------------%%%------------------------------------#
#--------------------------------------------$$-------------------------dd---------------------------#
#----------------------$$--------------------------------------------ddddddddd-----------------------#
#-----------------------$$$------------%%%%%%%%##---------------dddddddddd---------------------------#
#--------------------------------------%-------%--------------------dddddddd-------------------------#
#-----------------------------#--%%%%%%%--##---###----------------ddddd-----ddd----------------------#
#-----------------------------%-----------------%----------------------------------------------------#
#----------------------------%%%----w$$w---###%%-----------------------------------------------------#
#-----------------------------%%%-----------#--------------------------------------------------------#
#--------------------------------%%%%%%%%%%----------------------------------------------------------#
#----------------------------------------------------------------------------------------------------#
#----------------------------------------------------------------$$----------------------------------#
#----------------------------------------------------------------------------------------------------#
#--------$$$-----------------------------------------------------------------------------------------#
#----------------------------------------------------------------------------------------------------#
#----------------------------------------------------------------------------------------------------#
#----------------------------------------------------------------------------------------------------#
#--------------------------###-----------------------------------------------------------------------#
#----------------------------------------------------------------------------------------------------#
#----------------------------------------------------------------------------------------------------#
#----------------------------------------------------------------------------------------------------#
#----------------------------------------------------------------------------------------------------#
#----------------------------------------------------------------------------------------------------#
#---------------------------$$-----------------------------------------------------------------------#
#------------------------------------------------------------------------------------$$$-------------#
#--------------------------------------------------------------------------------------$$$-----------#
#----------------------------------------------------------------------------------------------------#
#----------------------------------------------------------------------------------------------------#
#----------------------------------------------------------------------------------------------------#
#----------------------------------------------------------------------------------------------------#
#----------------------------------------------------------------------------------------------------#
#----------------------------------------------------------------------------------------------------#
#----------------------------------------------------------------------------------------------------#
#----------------------------------------------------------------------------------------------------#
######################################################################################################
