######################################################################################################
#----------------------------------------------------------------------------------------------------#
#----------------------------------------------------------------------------------------------------#
#----------------------------------------------------------------------------------------------------#
#----------------------------------------------------------------------------------------------------#
#----------------------------------------------------------------------------------------------------#
#----------------------------------------------------------------------------------------------------#
#----------------------------------------------------------------------------------------------------#
#----------------------------------------------------------------------------------------------------#
#----------------------------------------------------------------------------------------------------#
#-------------------------------------####-----------------------------------------------------------#
#----------------------------------####--#-----------------------------------------------------------#
#---------------------------------##-----##----------------------------------------------------------#
#----------------------------------##---#####--------------------------------------------------------#
#-----------------------------------##-####----------------------------------------------------------#
#------------------------------------#-#-------------------------------------------------------------#
#----------------------------------------------------------------------------------------------------#		   #--#
#----------------------------------------------------------------------------------------------------#         #--#
#----------------------------------------------------------------------------------------------------###########--#
#-----------------------------------------------------------------------------------------------------------------#
#----------------------------------------------------------------------------------------------------##############
#----------------------------------------------------------------------------------------------------#
#----------------------------------------------------------------------------------------------------#
#----------------------------------------------------------------------------------------------------#
#----------------------------------------------------------------------------------------------------#
#----------------------------------------------------------------------------------------------------#
#----------------------------------------------------------------------------------------------------#
#----------------------------------------------------------------------------------------------------#
#----------------------------------------------------------------------------------------------------#
#----------------------------------------------------------------------------------------------------#
#----------------------------------------------------------------------------------------------------#
#----------------------------------------------------------------------------------------------------#
#----------------------------------------------------------------------------------------------------#
#----------------------------------------------------------------------------------------------------#
#----------------------------------------------------------------------------------------------------#
#----------------------------------------------------------------------------------------------------#
#----------------------------------------------------------------------------------------------------#
#----------------------------------------------------------------------------------------------------#
#----------------------------------------------------------------------------------------------------#
#----------------------------------------------------------------------------------------------------#
#----------------------------------------------------------------------------------------------------#
#----------------------------------------------------------------------------------------------------#
#----------------------------------------------------------------------------------------------------#
#----------------------------------------------------------------------------------------------------#
#----------------------------------------------------------------------------------------------------#
#----------------------------------------------------------------------------------------------------#
#----------------------------------------------------------------------------------------------------#
#----------------------------------------------------------------------------------------------------#
#----------------------------------------------------------------------------------------------------#
#----------------------------------------------------------------------------------------------------#
#----------------------------------------------------------------------------------------------------#
######################################################################################################
