######################################################################################################
#----------------------------------------------------------------------------------------------------#
#----------------------------------------------------------------------------------------------------#
#----------------------------------------------------------------------------------------------------#
#----------------------------------------------------------------------------------------------------#
#----------------------------------------------------------------------------------------------------#
#----------------------------------------------------------------------------------------------------#
#----------------------------------------------------------------------------------------------------#
#----------------------------------------------------------------------------------------------------#
#----------------------------------------------------------------------------------------------------#
#-------------------------------------####-----------------------------------------------------------#
#----------------------------------####--#-----------------------------------------------------------#
#---------------------------------##-----##----------------------------------------------------------#
#----------------------------------##---#####--------------------------------------------------------#
#-----------------------------------##-####----------------------------------------------------------#
#------------------------------------#-#-------------------------------------------------------------#
#----------------------------------------------------------------------------------------------------#
#----------------------------------------------------------------------------------------------------#
#----------------------------------------------------------------------------------------------------#
#----------------------------------------------------------------------------------------------------#
#----------------------------------------------------------------------------------------------------#
#----------------------------------------------------------------------------------------------------#
#----------------------------------------------------------------------------------------------------#
#----------------------------------------------------------------------------------------------------#
#----------------------------------------------------------------------------------------------------#
#----------------------------------------------------------------------------------------------------#
#----------------------------------------------------------------------------------------------------#
#----------------------------------------------------------------------------------------------------#
#----------------------------------------------------------------------------------------------------#
#----------------------------------------------------------------------------------------------------#
#----------------------------------------------------------------------------------------------------#
#----------------------------------------------------------------------------------------------------#
#----------------------------------------------------------------------------------------------------#
#----------------------------------------------------------------------------------------------------#
#----------------------------------------------------------------------------------------------------#
#----------------------------------------------------------------------------------------------------#
#----------------------------------------------------------------------------------------------------#
#----------------------------------------------------------------------------------------------------#
#----------------------------------------------------------------------------------------------------#
#----------------------------------------------------------------------------------------------------#
#----------------------------------------------------------------------------------------------------#
#----------------------------------------------------------------------------------------------------#
#----------------------------------------------------------------------------------------------------#
#----------------------------------------------------------------------------------------------------#
#----------------------------------------------------------------------------------------------------#
#----------------------------------------------------------------------------------------------------#
#----------------------------------------------------------------------------------------------------#
#----------------------------------------------------------------------------------------------------#
#----------------------------------------------------------------------------------------------------#
#----------------------------------------------------------------------------------------------------#
#----------------------------------------------------------------------------------------------------#
######################################################################################################
