######################################################################################################
#----------------------------------------------------------------------------------------------------#
#----------------------------------------------------------------------------------------------------#
#----------------------------------------------------------------------------------------------------#
#----------------------------------------------------------------------------------------------------#
#----------------------------------------------------------------------------------------------------#
#----------------------------------------------------------------------------------------------------#
#----------------------------------------------------------------------------------------------------#
#----------------------------------------------------------------------------------------------------#
#----------------------------------------------------------------------------------------------------#
#--------------------------------------###-----------------------------------------------------------#
#-------------------------------------#--#-----------------------------------------------------------#
#----------------------------------------##----------------------------------------------------------#
#----------------------------------------------------------------------------------------------------#
#----------------------------------------------------------------------------------------------------#
#----------------------------------------------------------------------------------------------------#
#----------------------------------------------------------------------------------------------------#
#----------------------------------------------------------------------------------------------------#         #
#----------------------------------------------------------------------------------------------------###########
#--------------------------------------------------------------------------------------------------------------
#----------------------------------------------------------------------------------------------------###########
#----------------------------------------------------------------------------------------------------#
#----------------------------------------------------------------------------------------------------#
#----------------------------------------------------------------------------------------------------#
#----------------------------------------------------------------------------------------------------#
#----------------------------------------------------------------------------------------------------#
#----------------------------------------------------------------------------------------------------#
#----------------------------------------------------------------------------------------------------#
#----------------------------------------------------------------------------------------------------#
#----------------------------------------------------------------------------------------------------#
#----------------------------------------------------------------------------------------------------#
#----------------------------------------------------------------------------------------------------#
#----------------------------------------------------------------------------------------------------#
#----------------------------------------------------------------------------------------------------#
#----------------------------------------------------------------------------------------------------#
#----------------------------------------------------------------------------------------------------#
#----------------------------------------------------------------------------------------------------#
#----------------------------------------------------------------------------------------------------#
#----------------------------------------------------------------------------------------------------#
#----------------------------------------------------------------------------------------------------#
#----------------------------------------------------------------------------------------------------#
#----------------------------------------------------------------------------------------------------#
#----------------------------------------------------------------------------------------------------#
#----------------------------------------------------------------------------------------------------#
#----------------------------------------------------------------------------------------------------#
#----------------------------------------------------------------------------------------------------#
#----------------------------------------------------------------------------------------------------#
#----------------------------------------------------------------------------------------------------#
#----------------------------------------------------------------------------------------------------#
#----------------------------------------------------------------------------------------------------#
#----------------------------------------------------------------------------------------------------#
######################################################################################################
